C 255,20 ,30
R  2147483647 2147483647
NO      ./textures/wood.xpm


SO ./textures/greystone.xpm
EA ./textures/red.xpm
WE ./textures/purplestone.xpm

F  000, 000, 00

111111111111111111111111
100000011000001000000001
11111111100000000000000011111
100000000000000000111000100001
110000100000000000000000001111
111000111111100000000000111111
1111111000000000W0000000000001
11110000000000110000000000011
110000000000011110000000000011
100000000000111000000000000011
110000000000111000000000001111
110000000001111000000000000111
111111111111111111111111111111111
